10b2	10base-2
10b5	10base-5
10b-f	10base-f
10b-fb	10base-fb
10b-fl	10base-fl
10b-fp	10base-fp
10b-t	10base-t
100b-fx	100base-fx
100b-t	100base-t
100b-tx	100base-tx
100bvg	100base-vg
286	intel_80286_processor
2b1q	2_binary_1_quaternary
2gl	second-generation_programming_language
2nf	second_normal_form
3gl	third-generation_programming_language
3nf	third_normal_form
386	intel_80386_processor
486	intel_80486_processor
4b5b	f—4_byte_5_byte_local_fiber
4gl	fourth-generation_programming_language
4nf	fourth_normal_form
5gl	fifth-generation_programming_language
5nf	fifth_normal_form
6nf	sixth_normal_form
8b10blf	8_byte_10_byte_local_fiber
aaa	authentication_authorization,_accounting
aabb	axis_aligned_bounding_box
aac	advanced_audio_coding
aal	atm_adaptation_layer
aalc	atm_adaptation_layer_connection
aarp	appletalk_address_resolution_protocol
abcl	actor-based_concurrent_language
abi	application_binary_interface
abm	asynchronous_balanced_mode
abr	area_border_router
abr	auto_baud-rate_detection
abr	available_bitrate
abr	average_bitrate
ac	acoustic_coupler
ac	alternating_current
acd	automatic_call_distributor
ace	advanced_computing_environment
acid	atomicity_consistency_isolation_durability
ack	acknowledgement
ack	amsterdam_compiler_kit
acl	access_control_list
acl	active_current_loop
acm	association_for_computing_machinery
acme	automated_classification_of_medical_entities
acp	airline_control_program
acpi	advanced_configuration_and_power_interface
acr	allowed_cell_rate
acr	attenuation_to_crosstalk_ratio
ad	active_directory
ad	administrative_domain
adc	analog-to-digital_converter
adc	apple_display_connector
adb	apple_desktop_bus
adccp	advanced_data_communications_control_procedures
ado	activex_data_objects
adsl	asymmetric_digital_subscriber_line
adt	abstract_data_type
ae	adaptive_equalizer
aes	advanced_encryption_standard
af	anisotropic_filtering
afp	apple_filing_protocol
agp	accelerated_graphics_port
ah	active_hub
ai	artificial_intelligence
aix	advanced_interactive_executive
ajax	asynchronous_javascript_and_xml
al	active_link
al	access_list
alac	apple_lossless_audio_codec
algol	algorithmic_language
alsa	advanced_linux_sound_architecture
alu	arithmetic_and_logical_unit
am	access_method
am	active_matrix
amoled	active-matrix_organic_light-emitting_diode
am	active_monitor
am	allied_mastercomputer
am	amplitude_modulation
amd	advanced_micro_devices
amqp	advanced_message_queuing_protocol
amr	audio_modem_riser
ann	artificial_neural_network
ansi	american_national_standards_institute
ant	another_neat_tool
aoe	ata_over_ethernet
aop	aspect-oriented_programming
apci	application-layer_protocol_control_information
api	application_programming_interface
apic	advanced_programmable_interrupt_controller
apipa	automatic_private_ip_addressing
apl	a_programming_language
apr	apache_portable_runtime
arc	adaptive_replacement_cache
arc	advanced_risc_computing
arin	american_registry_for_internet_numbers
arm	advanced_risc_machines
aros	aros_research_operating_system
arp	address_resolution_protocol
arpa	address_and_routing_parameter_area
arpa	advanced_research_projects_agency
arpanet	advanced_research_projects_agency_network
as	access_server
ascii	american_standard_code_for_information_interchange
asg	abstract_semantic_graph
asic	application-specific_integrated_circuit
asimo	advanced_step_in_innovative_mobility
aslr	address_space_layout_randomization
asm	algorithmic_state_machine
asmp	asymmetric_multiprocessing
asn.1	abstract_syntax_notation_1
asp	active_server_pages
asp	application_service_provider
asr	asynchronous_signal_routine
ast	abstract_syntax_tree
assp	application-specific_standard_product
at	advanced_technology
at	access_time
at	active_terminator
ata	advanced_technology_attachment
atag	authoring_tool_accessibility_guidelines
atapi	advanced_technology_attachment_packet_interface
atm	asynchronous_transfer_mode
avc	advanced_video_coding
avi	audio_video_interleaved
awk	aho_weinberger_kernighan
awt	abstract_window_toolkit
b2b	business-to-business
b2c	business-to-consumer
bal	basic_assembly_language
bam	block_availability_map
bash	bourne-again_shell
basic	beginner's_all-purpose_symbolic_instruction_code
bbp	baseband_processor
bbs	bulletin_board_system
bcd	binary_coded_decimal
bcnf	boyce–codd_normal_form
beep	blocks_extensible_exchange_protocol
ber	bit_error_rate
bfd	bidirectional_forwarding_detection
bfd	binary_file_descriptor
bfs	breadth-first_search
bft	byzantine_fault_tolerant
bgp	border_gateway_protocol
bi	business_intelligence
bidi	bi-directional
bin	binary
binac	binary_automatic_computer
bind	berkeley_internet_name_domain
bios	basic_input_output_system
bjt	bipolar_junction_transistor
bit	binary_digit
blob	binary_large_object
blog	web_log
bmp	basic_multilingual_plane
bnc	bayonet_neill-concelman
boinc	berkeley_open_infrastructure_for_network_computing
bom	byte_order_mark
bootp	bootstrap_protocol
bpdu	bridge_protocol_data_unit
bpel	business_process_execution_language
bpl	broadband_over_power_lines
bpm	business_process_management
bpm	business_process_modeling
bps	bits_per_second
brm	business_reference_model
brms	business_rule_management_system
brr	business_readiness_rating
bsa	business_software_alliance
bsb	backside_bus
bsd	berkeley_software_distribution
bsod	blue_screen_of_death
bss	block_started_by_symbol
bt	bittorrent
bt	bluetooth
b_tam	basic_telecommunications_access_method
bw	bandwidth
byod	bring_your_own_device
ca	computer_architecture
cad	computer-aided_design
cae	computer-aided_engineering
caid	computer-aided_industrial_design
cai	computer-aided_instruction
cam	computer-aided_manufacturing
captcha	completely_automated_public_turing_test_to_tell_computers_and_humans_apart
cat	computer-aided_translation
caq	computer-aided_quality_assurance
case	computer-aided_software_engineering
cc	c_compiler
cd	compact_disc
cde	common_desktop_environment
cdma	code_division_multiple_access
cdn	content_delivery_network
cdp	continuous_data_protection
cd-r	cd-recordable
cd-rom	cd_read-only_memory
cd-rw	cd-rewritable
cdsa	common_data_security_architecture
cert	computer_emergency_response_team
ces	consumer_electronics_show
cf	compact_flash
cfd	computational_fluid_dynamics
cfg	context-free_grammar
cfg	control_flow_graph
cg	computer_graphics
cga	color_graphics_array
cgi	common_gateway_interface
cgi	computer-generated_imagery
cgt	computational_graph_theory
chap	challenge-handshake_authentication_protocol
chs	cylinder-head-sector
cidr	classless_inter-domain_routing
cifs	common_internet_filesystem
cim	common_information_model
cir	committed_information_rate
cisc	complex_instruction_set_computer
cjk	chinese,_japanese,_and_korean
cjkv	chinese,_japanese,_korean,_and_vietnamese
cli	command_line_interface
clr	common_language_runtime
cm	configuration_management
cm	content_management
cmmi	capability_maturity_model_integration
cmos	complementary_metal-oxide_semiconductor
cms	content_management_system
cn	canonical_name
cn	common_name
cnc	computer_numerical_control
cnr	communications_and_networking_riser
cobol	common_business-oriented_language
com	component_object_model
corba	common_object_request_broker_architecture
cots	commercial_off-the-shelf
cpa	cell_processor_architecture
cpan	comprehensive_perl_archive_network
cpri	common_public_radio_interface
cps	characters_per_second
cpu	central_processing_unit
cr	carriage_return
cran	comprehensive_r_archive_network
crc	cyclic_redundancy_check
crlf	carriage_return_line_feeds
crm	customer_relationship_management
crs	computer_reservations_system
crt	cathode_ray_tube
crud	create,_read,_update_and_delete
cs	cable_select
cs	computer_science
cse	computer_science_and_engineering
csi	common_system_interface
csp	communicating_sequential_processes
csrf	cross-site_request_forgery
css	cascading_style_sheets
css	content-scrambling_system
css	closed_source_software
css	cross-site_scripting
csv	comma-separated_values
ct	computerized_tomography
ctan	comprehensive_tex_archive_network
ctcp	client-to-client_protocol
cti	computer_telephony_integration
ctfe	compile_time_function_execution
ctl	computational_tree_logic
ctm	close_to_metal
cts	clear_to_send
ctss	compatible_time-sharing_system
cua	common_user_access
cvs	concurrent_versioning_system
dac	digital-to-analog_converter
dac	discretionary_access_control
dal	database_abstraction_layer
dao	data_access_object
dao	data_access_objects
dao	disk-at-once
dap	directory_access_protocol
darpa	defense_advanced_research_projects_agency
dat	digital_audio_tape
db	database
dba	database_administrator
dbcs	double_byte_character_set
dbms	database_management_system
dcc	direct_client-to-client
dccp	datagram_congestion_control_protocol
dcca	debian_common_core_alliance
dcl	data_control_language
dcs	distributed_control_system
dcmi	dublin_core_metadata_initiative
dcom	distributed_component_object_model
dd	double_density
dde	dynamic_data_exchange
ddl	data_definition_language
ddos	distributed_denial_of_service
ddr	double_data_rate
dec	digital_equipment_corporation
des	data_encryption_standard
dev	development
dfa	deterministic_finite_automaton
dfd	data_flow_diagram
dfs	depth-first_search
dfs	distributed_file_system
dgd	dworkin's_game_driver
dhcp	dynamic_host_configuration_protocol
dhtml	dynamic_hypertext_markup_language
dif	data_integrity_field
dimm	dual_inline_memory_module
din	deutsches_institut_für_normung
dip	dual_in-line_package
divx	digital_video_express
dkim	domain_keys_identified_mail
dl	download
dll	dynamic_link_library
dlna	digital_living_network_alliance
dma	direct_memory_access
dmca	digital_millennium_copyright_act
dmi	direct_media_interface
dml	data_manipulation_language
dml	definitive_media_library
dmr	dennis_m._ritchie
dmz	demilitarized_zone
dn	distinguished_name
dnd	drag-and-drop
dns	domain_name_system
doa	dead_on_arrival
docsis	data_over_cable_service_interface_specification
dom	document_object_model
dos	denial_of_service
dos	disk_operating_system
dp	dot_pitch
dpc	deferred_procedure_call
dpi	deep_packet_inspection
dpi	dots_per_inch
dpmi	dos_protected_mode_interface
dpms	display_power_management_signaling
dram	dynamic_random_access_memory
dr-dos	digital_research_-_disk_operating_system
dri	direct_rendering_infrastructure
drm	digital_rights_management
drm	direct_rendering_manager
dsa	digital_signature_algorithm
dsdl	document_schema_definition_languages
dsdm	dynamic_systems_development_method
dsl	digital_subscriber_line
dsl	domain-specific_language
dslam	digital_subscriber_line_access_multiplexer
dsn	database_source_name
dsn	data_set_name
dsp	digital_signal_processor
dsssl	document_style_semantics_and_specification_language
dtd	document_type_definition
dte	data_terminal_equipment
dtp	desktop_publishing
dtr	data_terminal_ready
dvd	digital_versatile_disc
dvd-r	dvd-recordable
dvd-rom	dvd-read_only_memory
dvd-rw	dvd-rewritable
dvi	digital_visual_interface
dvr	digital_video_recorder
dw	data_warehouse
eai	enterprise_application_integration
eap	extensible_authentication_protocol
ebcdic	extended_binary_coded_decimal_interchange_code
ebml	extensible_binary_meta_language
ecc	elliptic_curve_cryptography
ecma	european_computer_manufacturers_association
ecn	explicit_congestion_notification
ecos	embedded_configurable_operating_system
ecrs	expense_and_cost_recovery_system
eda	electronic_design_automation
edi	electronic_data_interchange
edo	extended_data_out
edsac	electronic_delay_storage_automatic_calculator
edvac	electronic_discrete_variable_automatic_computer
eeprom	electronically_erasable_programmable_read-only_memory
eff	electronic_frontier_foundation
efi	extensible_firmware_interface
efm	eight-to-fourteen_modulation
ega	enhanced_graphics_array
e-mail	electronic_mail
egp	exterior_gateway_protocol
eid	electronic_id_card
eide	enhanced_ide
eigrp	enhanced_interior_gateway_routing_protocol
eisa	extended_industry_standard_architecture
elf	extremely_low_frequency
elf	executable_and_linkable_format
elm	electronic_mail
emacs	editor_macros
ems	expanded_memory_specification
eniac	electronic_numerical_integrator_and_computer
eof	end_of_file
eol	end_of_line
eom	end_of_message
epic	explicitly_parallel_instruction_computing
eprom	erasable_programmable_read-only_memory
erd	entity-relationship_diagram
erm	entity-relationship_model
erp	enterprise_resource_planning
esb	enterprise_service_bus
escon	enterprise_systems_connection
esd	electrostatic_discharge
etl	extract,_transform,_load
esr	eric_steven_raymond
euc	extended_unix_code
eula	end_user_license_agreement
ewmh	extended_window_manager_hints
ext	extended_file_system
fap	fortran_assembly_program
fasm	flat_assembler
fat	file_allocation_table
faq	frequently_asked_questions
fbdimm	fully_buffered_dual_inline_memory_module
fc-al	fibre_channel_arbitrated_loop
fcb	file_control_block
fcs	frame_check_sequence
fdc	floppy_disk_controller
fds	fedora_directory_server
fdd	floppy_disk_drive
fddi	fiber_distributed_data_interface
fdma	frequency-division_multiple_access
fec	forward_error_correction
femb	front-end_motherboard
fet	field_effect_transistor
fhs	filesystem_hierarchy_standard
ficon	fiber_connectivity
fifo	first_in_first_out
fips	federal_information_processing_standards
fl	function_level
flac	free_lossless_audio_codec
flops	floating-point_operations_per_second
floss	free/libre/open_source_software
fmc	_fixed_mobile_convergence_"mobile_uc_or_unified_communications_over_wireless"
foldoc	free_on-line_dictionary_of_computing
fosdem	free_and_open_source_software_developers'_european_meeting
fosi	formatted_output_specification_instance
foss	free_and_open_source_software
fp	function_programming
fpga	field_programmable_gate_array
fps	floating_point_systems
fpu	floating_point_unit
fru	field_replaceable_unit
fs	file_system
fsb	front_side_bus
fsck	file_system_check
fsf	free_software_foundation
fsm	finite_state_machine
fttc	fiber_to_the_curb
ftth	fiber_to_the_home
fttp	fiber_to_the_premises
ftp	file_transfer_protocol
fqdn	fully_qualified_domain_name
fud	fear_uncertainty_doubt
fws	folding_white_space
fxp	file_exchange_protocol
fyi	for_your_information
g11n	globalization
gas	gnu_assembler
gb	gigabit
gb	gigabyte
gcc	gnu_compiler_collection
gcj	gnu_compiler_for_java
gcr	group_code_recording
gdb	gnu_debugger
gdi	graphics_device_interface
gfdl	gnu_free_documentation_license
gif	graphics_interchange_format
gigo	garbage_in,_garbage_out
gimp	gnu_image_manipulation_program
gimps	great_internet_mersenne_prime_search
gis	geographic_information_system
glut	opengl_utility_toolkit
gml	geography_markup_language
gnome	gnu_network_object_model_environment
gnu	gnu's_not_unix
goms	goals,_operators,_methods,_and_selection_rules
gpasm	gnu_pic_assembler
gpfs	general_parallel_file_system
gpg	gnu_privacy_guard
gpgpu	general-purpose_computing_on_graphics_processing_units
gpib	general-purpose_instrumentation_bus
gpl	general_public_license
gpl	general-purpose_language
gprs	general_packet_radio_service
gpt	guid_partition_table
gpu	graphics_processing_unit
grub	grand_unified_boot-loader
gsm	global_system_for_mobile_communications
gtk+	gimp_toolkit
gui	graphical_user_interface
guid	globally_unique_identifier
gwt	google_web_toolkit
ha	high_availability
hal	hardware_abstraction_layer
hba	host_bus_adapter
hci	human_computer_interaction
hd	high_density
hdd	hard_disk_drive
hcl	hardware_compatibility_list
hd_dvd	high_definition_dvd
hdl	hardware_description_language
hdmi	high-definition_multimedia_interface
hf	high_frequency
hfs	hierarchical_file_system
hhd	hybrid_hard_drive
hid	human_interface_device
hig	human_interface_guidelines
hird	hurd_of_interfaces_representing_depth
hlasm	high_level_assembler
hma	high_memory_area
hp	hewlett-packard
hpc	high-performance_computing
hpfs	high_performance_file_system
hsdpa	high-speed_downlink_packet_access
htc	high-throughput_computing
hsm	hierarchical_storage_management
ht	hyper_threading
htm	hierarchical_temporal_memory
html	hypertext_markup_language
http	hypertext_transfer_protocol
httpd	hypertext_transport_protocol_daemon
htx	hypertransport_expansion
hurd	hird_of_unix-replacing_daemons
hvd	holographic_versatile_disc
hz	hertz
i18n	internationalization
iana	internet_assigned_numbers_authority
ibcs	intel_binary_compatibility_standard
ibm	international_business_machines
ic	integrated_circuit
icann	internet_corporation_for_assigned_names_and_numbers
ice	in-circuit_emulator
ice	intrusion_countermeasure_electronics
icmp	internet_control_message_protocol
icp	internet_cache_protocol
ict	information_and_communication_technology
ide	integrated_development_environment
ide	integrated_drive_electronics
idf	intermediate_distribution_frame
idl	interface_definition_language
ids	intrusion_detection_system
ie	internet_explorer
iec	international_electrotechnical_commission
ieee	institute_of_electrical_and_electronics_engineers
ietf	internet_engineering_task_force
ifl	integrated_facility_for_linux
igmp	internet_group_management_protocol
igrp	interior_gateway_routing_protocol
ihv	independent_hardware_vendor
iiop	internet_inter-orb_protocol
iis	internet_information_services
il	intermediate_language
im	instant_messaging
imap	internet_message_access_protocol
ime	input_method_editor
infosec	information_systems_security
i/o	input/output
iot	internet_of_things
ip	intellectual_property
ip	internet_protocol
ipc	inter-process_communication
ipl	initial_program_load
ipo	inter_procedural_optimization
ipp	internet_printing_protocol
ips	in-plane_switching
ips	instructions_per_second
ips	intrusion_prevention_system
ipsec	internet_protocol_security
iptv	internet_protocol_television
ipx	internetwork_packet_exchange
ir	intermediate_representation
irc	internet_relay_chat
irda	infrared_data_association
iri	internationalized_resource_identifier
irq	interrupt_request
is	information_systems
is-is	intermediate_system_to_intermediate_system
isa	industry_standard_architecture
isa	instruction_set_architecture
isam	indexed_sequential_access_method
isc	internet_storm_center
iscsi	internet_small_computer_system_interface
isdn	integrated_services_digital_network
iso	international_organization_for_standardization
isns	internet_storage_name_service
isp	internet_service_provider
ispf	interactive_system_productivity_facility
isr	interrupt_service_routine
isv	independent_software_vendor
it	information_technology
itil	information_technology_infrastructure_library
itl	interval_temporal_logic
itu	international_telecommunication_union
ivrs	interactive_voice_response_system
j2ee	java_2_enterprise_edition
j2me	java_2_micro_edition
j2se	java_2_standard_edition
jaxb	java_architecture_for_xml_binding
jax-rpc	java_xml_for_remote_procedure_calls
jaxp	java_api_for_xml_processing
jbod	just_a_bunch_of_disks
jce	_java_cryptography_extension
jcl	job_control_language
jcp	java_community_process
jdbc	java_database_connectivity
jdk	java_development_kit
jee	java_enterprise_edition
jes	job_entry_subsystem
jds	java_desktop_system
jfc	java_foundation_classes
jfet	junction_field-effect_transistor
jfs	ibm_journaling_file_system
jini	jini_is_not_initials
jit	just-in-time
jme	java_micro_edition
jmx	java_management_extensions
jms	java_message_service
jndi	java_naming_and_directory_interface
jni	java_native_interface
jnz	jump_non-zero
jpeg	joint_photographic_experts_group
jre	java_runtime_environment
js	javascript
jse	java_standard_edition
json	javascript_object_notation
jsp	jackson_structured_programming
jsp	javaserver_pages
jtag	joint_test_action_group
jug	java_users_group
jvm	java_virtual_machine
k&amp;r	kernighan_and_ritchie
kb	keyboard
kb	kilobit
kb	kilobyte
kb	knowledge_base
kde	k_desktop_environment
khz	kilohertz
km	knowledge_machine
krl	knowledge_representation_language
kvm	keyboard,_video,_mouse
l10n	localization
l2tp	layer_two_tunneling_protocol
lamp	linux_apache_mysql_python
lan	local_area_network
lba	logical_block_addressing
lcd	liquid_crystal_display
lcr	least_cost_routing
lcos	liquid_crystal_on_silicon
ldap	lightweight_directory_access_protocol
le	logical_extents
led	light-emitting_diode
lf	line_feed
lf	low_frequency
lfs	linux_from_scratch
lgpl	lesser_general_public_license
lib	library
lif	low_insertion_force
lifo	last_in_first_out
lilo	linux_loader
lisp	list_processing
lkml	linux_kernel_mailing_list
lm	lan_manager
loc	lines_of_code
lpc	lars_pensjö_c
lpi	linux_professional_institute
lpt	_line_print_terminal
lsb	linux_standard_base
lsi	large-scale_integration
ltl	linear_temporal_logic
ltr	left-to-right
lug	linux_user_group
lun	logical_unit_number
lv	logical_volume
lvd	low_voltage_differential
lvm	logical_volume_management
lzw	lempel-ziv-welch
lga	land_grid_array
mac	mandatory_access_control
mac	media_access_control
man	metropolitan_area_network
manet	mobile_ad-hoc_network
mapi	messaging_application_programming_interface
mb	megabit
mb	megabyte
mbcs	multi_byte_character_set
mbd	model-based_design
mbr	master_boot_record
mca	micro_channel_architecture
mca	microsoft_certified_architect
mcad	microsoft_certified_application_developer
mcas	microsoft_certified_application_specialist
mcdba	microsoft_certified_database_administrator
mcdst	microsoft_certified_desktop_support_technician
mcitp	microsoft_certified_information_technology_professional
mcm	microsoft_certified_master
mcp	microsoft_certified_professional
mcpd	microsoft_certified_professional_developer
mcsa	microsoft_certified_systems_administrator
mcsd	microsoft_certified_solution_developer
mcse	microsoft_certified_systems_engineer
mct	microsoft_certified_trainer
mcts	microsoft_certified_technology_specialist
mda	monochrome_display_adapter
mdf	main_distribution_frame
mdi	multiple_document_interface
mf	medium_frequency
mfc	microsoft_foundation_classes
mfm	modified_frequency_modulation
mgcp	media_gateway_control_protocol
mhz	megahertz
mib	management_information_base
micr	magnetic_ink_character_recognition
midi	musical_instrument_digital_interface
mimd	multiple_instruction,_multiple_data
mimo	multiple-input_multiple-output
minix	mini-unix
mips	microprocessor_without_interlocked_pipeline_stages
mis	management_information_systems
misd	multiple_instruction,_single_data
mit	massachusetts_institute_of_technology
mime	multipurpose_internet_mail_extensions
mmds	mortality_medical_data_system
mmi	man_machine_interface.
mmio	memory-mapped_i/o
mmorpg	massively_multiplayer_online_role-playing_game
mmu	memory_management_unit
mmx	multi-media_extensions
mng	multiple-image_network_graphics
mobo	motherboard
mom	message-oriented_middleware
moo	mud_object_oriented
mop	meta-object_protocol
mos	microsoft_office_specialist
mosfet	metal-oxide_semiconductor_field_effect_transistor
mous	microsoft_office_user_specialist
mpaa	motion_picture_association_of_america
mpeg	motion_pictures_experts_group
mpl	mozilla_public_license
mpls	multiprotocol_label_switching
mpu	microprocessor_unit
ms	memory_stick
msb	most_significant_bit
ms-dos	microsoft_dos
mt	machine_translation
mta	mail_transfer_agent
mta	microsoft_technology_associate
mtbf	mean_time_between_failures
mtu	maximum_transmission_unit
msa	mail_submission_agent
msdn	microsoft_developer_network
msi	medium-scale_integration
mua	mail_user_agent
mud	multi-user_dungeon
mvc	model-view-controller
mvp	most_valuable_professional
mvs	multiple_virtual_storage
mwc	mobile_world_congress
mx	mail_exchange
mxf	material_exchange_format
nack	negative_acknowledgement
nak	negative_acknowledge_character
nan	not_a_number
nas	network-attached_storage
nasm	netwide_assembler
nat	network_address_translation
ncp	netware_core_protocol
ncq	native_command_queuing
ncsa	national_center_for_supercomputing_applications
ndps	novell_distributed_print_services
nds	novell_directory_services
nep	network_equipment_provider
netbios	network_basic_input/output_system
next	near-end_crosstalk
nfa	nondeterministic_finite_automaton
nfc	near_field_communication
nfs	network_file_system
ngl	angel
ngscb	next-generation_secure_computing_base
ni	national_instruments
nic	network_interface_controller
nim	no_internal_message
nio	new_i/o
nist	national_institute_of_standards_and_technology
nlp	natural_language_processing
nls	native_language_support
nmi	non-maskable_interrupt
np	nondeterministic_polynomial_time
npl	netscape_public_license
npu	network_processing_unit
ns	netscape
nsa	national_security_agency
nspr	netscape_portable_runtime
nntp	network_news_transfer_protocol
noc	network_operations_center
nop	no_operation
nos	network_operating_system
nptl	native_posix_thread_library
nss	novell_storage_service
nss	network_security_services
nss	name_service_switch
nt	new_technology
ntfs	nt_filesystem
ntlm	nt_lan_manager
ntp	network_time_protocol
numa	non-uniform_memory_access
nurbs	non-uniform_rational_b-spline
nvr	network_video_recorder
nvram	non-volatile_random_access_memory
oasis	organization_for_the_advancement_of_structured_information_standards
oat	operational_acceptance_testing
obsai	open_base_station_architecture_initiative
odbc	open_database_connectivity
oem	original_equipment_manufacturer
oes	open_enterprise_server
oftc	open_and_free_technology_community
oid	object_identifier
olap	online_analytical_processing
ole	object_linking_and_embedding
oled	organic_light_emitting_diode
olpc	one_laptop_per_child
oltp	online_transaction_processing
omf	object_module_format
omg	object_management_group
omr	optical_mark_reader
oo	object-oriented
oo	openoffice
ooe	out-of-order_execution
oom	out_of_memory
ooo	openoffice.org
oooe	out-of-order_execution
oop	object-oriented_programming
ootb	out_of_the_box
opml	outline_processor_markup_language
orb	object_request_broker
orm	object-relational_mapping
os	operating_system
oscon	o'reilly_open_source_convention
osdn	open_source_developer_network
osi	open_source_initiative
osi	open_systems_interconnection
ospf	open_shortest_path_first
oss	open_sound_system
oss	open-source_software
oss	operations_support_system
ostg	open_source_technology_group
oui	organisationally_unique_identifier
p2p	peer-to-peer
paas	platform_as_a_service
pan	personal_area_network
pap	password_authentication_protocol
parc	palo_alto_research_center
pata	parallel_ata
pbs	portable_batch_system
pc	personal_computer
pcb	printed_circuit_board
pcb	process_control_block
pc_dos	personal_computer_disc_operating_system
pci	peripheral_component_interconnect
pcie	pci_express
pcl	printer_command_language
pcmcia	personal_computer_memory_card_international_association
pcm	pulse-code_modulation
pcre	perl_compatible_regular_expressions
pd	public_domain
pda	personal_digital_assistant
pdf	portable_document_format
pdh	plesiochronous_digital_hierarchy
pdp	programmed_data_processor
pe	physical_extents
perl	practical_extraction_and_reporting_language
pga	pin_grid_array
pga	programmable_gate_array
pgo	profile-guided_optimization
pgp	pretty_good_privacy
php	hypertext_preprocessor
pic	peripheral_interface_controller
pic	programmable_interrupt_controller
pid	proportional-integral-derivative
pid	process_id
pim	personal_information_manager
pine	program_for_internet_news_and_email
pim	platform_independent_model
pio	programmed_input/output
pkcs	public_key_cryptography_standards
pki	public_key_infrastructure
plc	power_line_communication
plc	programmable_logic_controller
pld	programmable_logic_device
pl/i	programming_language_one
pl/m	programming_language_for_microcomputers
pl/p	programming_language_for_prime
plt	power_line_telecommunications
pmm	post_memory_manager
png	portable_network_graphics
pnp	plug-and-play
poe	power_over_ethernet
poid	persistent_object_identifier
pojo	plain_old_java_object
pop	point_of_presence
pop3	post_office_protocol_v3
posix	portable_operating_system_interface,_formerly_ieee-ix
post	power-on_self_test
ppc	powerpc
ppi	pixels_per_inch
ppp	point-to-point_protocol
pppoa	ppp_over_atm
pppoe	ppp_over_ethernet
pptp	point-to-point_tunneling_protocol
pr	pull_request
ps	postscript
ps/2	personal_system/2
psa	professional_services_automation
psm	platform_specific_model
psu	power_supply_unit
psvi	post-schema-validation_infoset
pts-dos	phystechsoft_-_disk_operating_system
pv	physical_volume
pvg	physical_volume_group
pvr	personal_video_recorder
pxe	preboot_execution_environment
pxi	pci_extensions_for_instrumentation
qdr	quad_data_rate
qa	quality_assurance
qfp	quad_flat_package
qos	quality_of_service
qotd	quote_of_the_day
qt	quasar_toolkit
qtam	queued_teleprocessing_access_method
racf	resource_access_control_facility
rad	rapid_application_development
radius	remote_authentication_dial_in_user_service
raid	redundant_array_of_independent_disks
raid	redundant_array_of_inexpensive_disks
raii	resource_acquisition_is_initialization
rait	redundant_array_of_inexpensive_tapes
ram	random_access_memory
rarp	reverse_address_resolution_protocol
ras	reliability,_availability_and_serviceability
ras	remote_access_service
rras	routing_and_remote_access_service
rc	region_code
rc	release_candidate
rc	run_commands
rcs	revision_control_system
rdbms	relational_database_management_system
rdc	remote_desktop_connection
rdf	resource_description_framework
rdm	relational_data_model
rdos	real-time_disk_operating_system
rds	remote_data_services
refal	recursive_functions_algorithmic_language
rest	representational_state_transfer
regex	regular_expression
regexp	regular_expression
rf	radio_frequency
rfc	request_for_comments
rfi	radio_frequency_interference
rfid	radio_frequency_identification
rgb	red,_green,_blue
rhl	red_hat_linux
rhel	red_hat_enterprise_linux
ria	rich_internet_application
riaa	recording_industry_association_of_america
rip	raster_image_processor
rip	routing_information_protocol
rir	regional_internet_registry
risc	reduced_instruction_set_computer
risc_os	reduced_instruction_set_computer_operating_system
rje	remote_job_entry
rle	run-length_encoding
rll	run-length_limited
rmi	remote_method_invocation
rms	richard_matthew_stallman
rom	read_only_memory
romb	read-out_motherboard
rom-dos	read_only_memory_-_disk_operating_system
rpc	remote_procedure_call
rpg	report_program_generator
rpm	rpm_package_manager
rsa	rivest_shamir_adleman
rsi	repetitive_strain_injury
rss	radio_service_software
rss	rich_site_summary,_rdf_site_summary,_or_really_simple_syndication
rtai	real-time_application_interface
rtc	real-time_clock
rte	real-time_enterprise
rtems	real-time_executive_for_multiprocessor_systems
rtl	right-to-left
rtos	real-time_operating_system
rtp	real-time_transport_protocol
rts	ready_to_send
rtsp	real_time_streaming_protocol
rtti	run-time_type_information
rwd	responsive_web_design
saas	software_as_a_service
san	storage_area_network
sas	serial_attached_scsi
sata	serial_ata
sax	simple_api_for_xml
sbod	spinning_beachball_of_death
sbp-2	serial_bus_protocol_2
sbin	superuser_binary
sbu	standard_build_unit
scada	supervisory_control_and_data_acquisition
scid	source_code_in_database
scm	software_configuration_management
scm	source_code_management
scp	secure_copy
scpi	standard_commands_for_programmable_instrumentation
scsi	small_computer_system_interface
sctp	stream_control_transmission_protocol
sd	secure_digital
sddl	security_descriptor_definition_language
sdh	synchronous_digital_hierarchy
sdi	single_document_interface
sdio	secure_digital_input_output
sdk	software_development_kit
sdl	simple_directmedia_layer
sdn	service_delivery_network
sdp	session_description_protocol
sdr	software-defined_radio
sdram	synchronous_dynamic_random_access_memory
sdsl	symmetric_dsl
se	single_ended
sei	software_engineering_institute
seo	search_engine_optimization
sftp	secure_ftp
sftp	simple_file_transfer_protocol
sftp	ssh_file_transfer_protocol
sgi	silicon_graphics,_incorporated
sgml	standard_generalized_markup_language
sgr	select_graphic_rendition
sha	secure_hash_algorithm
shdsl	single-pair_high-speed_digital_subscriber_line
sigcat	special_interest_group_on_cd-rom_applications_and_technology
siggraph	special_interest_group_on_graphics
simd	single_instruction,_multiple_data
simm	single_inline_memory_module
sip	session_initiation_protocol
sip	supplementary_ideographic_plane
sisd	single_instruction,_single_data
siso	single-input_and_single-output
sled	suse_linux_enterprise_desktop
sles	suse_linux_enterprise_server
sli	scalable_link_interface
slip	serial_line_internet_protocol
slm	service_level_management
sloc	source_lines_of_code
sme	subject_matter_expert
spm	software_project_management
spmd	single_program,_multiple_data
sma	subminiature_version_a
smb	server_message_block
smbios	system_management_bios
smil	synchronized_multimedia_integration_language
s/mime	secure/multipurpose_internet_mail_extensions
smp	supplementary_multilingual_plane
smp	symmetric_multi-processing
sms	short_message_service
sms	system_management_server
smt	simultaneous_multithreading
smtp	simple_mail_transfer_protocol
sna	systems_network_architecture
snmp	simple_network_management_protocol
sntp	simple_network_time_protocol
soa	service-oriented_architecture
soap	simple_object_access_protocol
soap	symbolic_optimal_assembly_program
sopa	stop_online_piracy_act
soc	system-on-a-chip
so-dimm	small_outline_dimm
soe	standard_operating_environment
soho	small_office/home_office
soi	silicon_on_insulator
sp	service_pack
spa	single_page_application
spf	sender_policy_framework
spi	serial_peripheral_interface
spi	stateful_packet_inspection
sparc	scalable_processor_architecture
sql	structured_query_language
sram	static_random_access_memory
ssa	static_single_assignment
ssd	software_specification_document
ssd	solid-state_drive
sse	streaming_simd_extensions
ssh	secure_shell
ssi	server_side_includes
ssi	single-system_image
ssi	small-scale_integration
ssid	service_set_identifier
ssl	secure_socket_layer
ssp	supplementary_special-purpose_plane
ssse	supplementary_streaming_simd_extensions
su	superuser
sus	single_unix_specification
suse	software_und_system-entwicklung
svc	scalable_video_coding
svg	scalable_vector_graphics
svga	super_video_graphics_array
svd	structured_vlsi_design
swf	shock_wave_flash
swt	standard_widget_toolkit
sysop	system_operator
tao	track-at-once
tasm	turbo_assembler
tb	terabyte
tcl	tool_command_language
tcp	transmission_control_protocol
tcp/ip	transmission_control_protocol/internet_protocol
tcu	telecommunication_control_unit
tdma	time_division_multiple_access
tft	thin_film_transistor
tftp	trivial_file_transfer_protocol
ti	texas_instruments
tla	three-letter_acronym
tld	top-level_domain
tls	thread-local_storage
tls	transport_layer_security
tlv	type-length-value
tmp	temporary
tnc	terminal_node_controller
tnc	threaded_neill-concelman_connector
tpf	transaction_processing_facility
troff	trace_off
tron	trace_on
tron	the_real-time_operating_system_nucleus
trs-dos	tandy_radio_shack_-_disk_operating_system
tso	time_sharing_option
tsp	traveling_salesman_problem
tsr	terminate_and_stay_resident
tta	true_tap_audio
ttf	truetype_font
ttl	transistor-transistor_logic
ttl	time_to_live
tts	text-to-speech
tty	teletype
tucows	the_ultimate_collection_of_winsock_software
tug	tex_users_group
twain	technology_without_an_interesting_name
uaag	user_agent_accessibility_guidelines
uac	user_account_control
uart	universal_asynchronous_receiver/transmitter
uat	user_acceptance_testing
ucs	universal_character_set
uddi	universal_description,_discovery,_and_integration
udma	ultra_dma
udp	user_datagram_protocol
uefi	unified_extensible_firmware_interface
uhf	ultra_high_frequency
ui	user_interface
ul	upload
ula	uncommitted_logic_array
uma	upper_memory_area
umb	upper_memory_block
uml	unified_modeling_language
umpc	ultra-mobile_personal_computer
unc	universal_naming_convention
ups	uninterruptible_power_supply
uri	uniform_resource_identifier
url	uniform_resource_locator
urn	uniform_resource_name
usb	universal_serial_bus
usr	u.s._robotics
utc	coordinated_universal_time
utf	unicode_transformation_format
utp	unshielded_twisted_pair
uucp	unix_to_unix_copy
uuid	universally_unique_identifier
uvc	universal_virtual_computer
ux	user_experience
var	variable
vax	virtual_address_extension
vcpi	virtual_control_program_interface
vr	virtual_reality
vrml	virtual_reality_modeling_language
vb	visual_basic
vba	visual_basic_for_applications
vbs	visual_basic_script
vdsl	very_high_bitrate_digital_subscriber_line
vesa	video_electronics_standards_association
vfat	virtual_fat
vfs	virtual_file_system
vg	volume_group
vga	video_graphics_array
vga	video_graphics_adapter
vhf	very_high_frequency
vlan	virtual_local_area_network
vlsm	variable_length_subnet_mask
vlb	vesa_local_bus
vlf	very_low_frequency
vliw	very_long_instruction_word
vlsi	very-large-scale_integration
vm	virtual_machine
vm	virtual_memory
vnc	virtual_network_computing
vod	video_on_demand
voip	voice_over_internet_protocol
vpn	virtual_private_network
vpu	visual_processing_unit
vsam	virtual_storage_access_method
vsat	very_small_aperture_terminal
vt	video_terminal?
vtam	virtual_telecommunications_access_method
w3c	world_wide_web_consortium
wafs	wide_area_file_services
wai	web_accessibility_initiative
wais	wide_area_information_server
wan	wide_area_network
wap	wireless_access_point
wap	wireless_application_protocol
wasm	watcom_assembler
wbem	web-based_enterprise_management
wcag	web_content_accessibility_guidelines
wcf	windows_communication_foundation
wdm	wavelength-division_multiplexing
webdav	www_distributed_authoring_and_versioning
wep	wired_equivalent_privacy
wfi	wait_for_interrupt
wimax	worldwide_interoperability_for_microwave_access
winfs	windows_future_storage
wins	windows_internet_name_service
wlan	wireless_local_area_network
wma	windows_media_audio
wmv	windows_media_video
wol	wake-on-lan
wor	wake-on-ring
wora	write_once,_run_anywhere
wore	write_once,_run_everywhere
wpa	wi-fi_protected_access
wpan	wireless_personal_area_network
wpf	windows_presentation_foundation
wsdl	web_services_description_language
wsfl	web_services_flow_language
wusb	wireless_universal_serial_bus
wwan	wireless_wide_area_network
wwid	world_wide_identifier
wwn	world_wide_name
www	world_wide_web
wysiwyg	what_you_see_is_what_you_get
wzc	wireless_zero_configuration
xaml	extensible_application_markup_language
xdm	x_window_display_manager
xdmcp	x_display_manager_control_protocol
xcbl	xml_common_business_library
xhtml	extensible_hypertext_markup_language
xilp	x_interactive_listproc
xml	extensible_markup_language
xmms	x_multimedia_system
xmpp	extensible_messaging_and_presence_protocol
xms	extended_memory_specification
xns	xerox_network_systems
xp	cross-platform
xp	extreme_programming
xpcom	cross_platform_component_object_model
xpi	xpinstall
xpidl	cross-platform_idl
xps	_xml_paper_specification
xsd	xml_schema_definition
xsl	extensible_stylesheet_language
xsl-fo	extensible_stylesheet_language_formatting_objects
xslt	extensible_stylesheet_language_transformations
xss	cross-site_scripting
xtf	extensible_tag_framework
xtf	extended_triton_format
xul	xml_user_interface_language
xvga	extended_video_graphics_adapter
y2k	year_two_thousand
yaaf	yet_another_application_framework
yacc	yet_another_compiler_compiler
yaml	yaml_ain't_markup_language
yast	yet_another_setup_tool
zcav	zone_constant_angular_velocity
zcs	zero_code_suppression
zif	zero_insertion_force
zifs	zero_insertion_force_socket
zisc	zero_instruction_set_computer
zoi	zero_one_infinity
zope	z_object_publishing_environment
zma	zone_multicast_address
dbn	deep_belief_networks
dnn	deep_neural_networks
cnn	convolutional_neural_networks
rbm	restricted_boltzmann_machine
e-mail	electronic_mail
svm	support_vector_machine
cuda	compute_unified_device_architecture
sns	social_network_services
hmm	hidden_markov_models
learning_(artificial_intelligence)	machine_learning
ontologies_(artificial_intelligence)	ontologies
planning_(artificial_intelligence)	planning
generalisation_(artificial_intelligence)	generalisation
social_networking_(online)	social_networking
trees_(mathematics)	trees
support_vector_machine_(svm)	support_vector_machine
artificial_neural_network_(ann)	artificial_neural_network
biometrics_(access_control)	biometrics
particle_filtering_(numerical_methods)	particle_filtering
splines_(mathematics)	splines
artificial_intelligence_(ai)	artificial_intelligence
network_theory_(graphs)	network_theory
mobility_management_(mobile_radio)	mobility_management
operating_systems_(computers)	operating_systems
particle_swarm_optimization_(pso)	particle_swarm_optimization
reinforcement_learning_(rl)	reinforcement_learning
genetic_algorithm_(ga)	genetic_algorithm
extreme_learning_machine_(elm)	extreme_learning_machine
question_answering_(information_retrieval)	question_answering
quantisation_(signal)	quantisation
rendering_(computer_graphics)	rendering
slam_(robots)	slam
support_vector_machines_(svms)	support_vector_machines
peak-to-average_power_ratio_(papr)	peak-to-average_power_ratio
principal_component_analysis_(pca)	principal_component_analysis
android_(operating_system)	android
medium_access_control_(mac)	medium_access_control
evolution_(biological)	evolution
artificial_neural_networks_(ann)	artificial_neural_networks
neural_network_(nn)	neural_network
case-based_reasoning_(cbr)	case-based_reasoning
self-organizing_map_(som)	self-organizing_map
support_vector_machines_(svm)	support_vector_machines
load_(electric)	load
analytic_network_process_(anp)	analytic_network_process
linear_matrix_inequalities_(lmis)	linear_matrix_inequalities
hidden_markov_model_(hmm)	hidden_markov_model
artificial_neural_networks_(anns)	artificial_neural_networks
source_code_(software)	source_code
serious_games_(computing)	serious_games
drawing_(mechanical)	drawing
support_vector_regression_(svr)	support_vector_regression
multiple_kernel_learning_(mkl)	multiple_kernel_learning
mobile_ad_hoc_network_(manet)	mobile_ad_hoc_network
failure_(mechanical)	failure
series_(mathematics)	series
peer-to-peer_(p2p)	peer-to-peer
mouse_controllers_(computers)	mouse_controllers
active_learning_(al)	active_learning
multi-agent_system_(mas)	multi-agent_system
genetic_programming_(gp)	genetic_programming
passive_optical_network_(pon)	passive_optical_network
relay_networks_(telecommunication)	relay_networks
linear_discriminant_analysis_(lda)	linear_discriminant_analysis
carrier_frequency_offset_(cfo)	carrier_frequency_offset
rods_(structures)	rods
fuzzy_neural_network_(fnn)	fuzzy_neural_network
batch_processing_(industrial)	batch_processing
rings_(structures)	rings
radial_basis_function_neural_network_(rbfnn)	radial_basis_function_neural_network
virtual_private_network_(vpn)	virtual_private_network
data_envelopment_analysis_(dea)	data_envelopment_analysis
radial_basis_function_(rbf)_neural_networks	radial_basis_function
neural_networks_(nns)	neural_networks
multilayer_perceptron_(mlp)	multilayer_perceptron
interference_(signal)	interference
orthogonal_frequency_division_multiple_access_(ofdma)	orthogonal_frequency_division_multiple_access
ant_colony_optimization_(aco)	ant_colony_optimization
artificial_bee_colony_(abc)_algorithm	artificial_bee_colony
selected_mapping_(slm)	selected_mapping
quality_of_service_(qos)	quality_of_service
relevance_vector_machine_(rvm)	relevance_vector_machine
web_ontology_language_(owl)	web_ontology_language
field_programmable_gate_array_(fpga)	field_programmable_gate_array
learning_vector_quantization_(lvq)	learning_vector_quantization
computational_intelligence_(ci)	computational_intelligence
single_photon_emission_computed_tomography_(spect)	single_photon_emission_computed_tomography
fuzzy_logic_controller_(flc)	fuzzy_logic_controller
internet_of_things_(iot)	internet_of_things
cellular_neural_networks_(cnns)	cellular_neural_networks
genetic_algorithms_(gas)	genetic_algorithms
networked_control_systems_(ncs)	networked_control_systems
network-on-chip_(noc)	network-on-chip
artificial_bee_colony_(abc)	artificial_bee_colony
semisupervised_learning_(ssl)	semisupervised_learning
optical_burst_switching_(obs)	optical_burst_switching
model_driven_engineering_(mde)	model_driven_engineering
electroencephalogram_(eeg)	electroencephalogram
buildings_(structures)	buildings
electroencephalography_(eeg)	electroencephalography
markov_decision_process_(mdp)	markov_decision_process
wavelength-division_multiplexing_(wdm)	wavelength-division_multiplexing
bridges_(structures)	bridges
back_propagation_(bp)_neural_network	back_propagation
beams_(structures)	beams
pulse_coupled_neural_network_(pcnn)	pulse_coupled_neural_network
distributed_artificial_intelligence_(dai)	distributed_artificial_intelligence
service-oriented_architecture_(soa)	service-oriented_architecture
tanks_(containers)	tanks
multi-agent_systems_(mas)	multi-agent_systems
wireless_mesh_networks_(wmns)	wireless_mesh_networks
decision_support_system_(dss)	decision_support_system
radial_basis_function_(rbf)	radial_basis_function
density_functional_theory_(dft)	density_functional_theory
differential_evolution_(de)	differential_evolution
network_coding_(nc)	network_coding
functional_magnetic_resonance_imaging_(fmri)	functional_magnetic_resonance_imaging
brain-computer_interface_(bci)	brain-computer_interface
plates_(structures)	plates
content-based_image_retrieval_(cbir)	content-based_image_retrieval
interpenetrating_networks_(ipn)	interpenetrating_networks
named_entity_recognition_(ner)	named_entity_recognition
artificial_immune_system_(ais)	artificial_immune_system
natural_language_processing_(nlp)	natural_language_processing
computed_tomography_(ct)	computed_tomography
magnetic_resonance_imaging_(mri)	magnetic_resonance_imaging
ethernet_passive_optical_network_(epon)	ethernet_passive_optical_network
depth_image_based_rendering_(dibr)	depth_image_based_rendering
singular_value_decomposition_(svd)	singular_value_decomposition
expert_system_(es)	expert_system
random_forest_(rf)	random_forest
cfd_(computational_fluid_dynamics)	cfd
heterogeneous_(hybrid)_systems	heterogeneous
sparse_bayesian_learning_(sbl)	sparse_bayesian_learning
markov_random_field_(mrf)	markov_random_field
electronic_control_unit_(ecu)	electronic_control_unit
delay-tolerant_networks_(dtns)	delay-tolerant_networks
educational_data_mining_(edm)	educational_data_mining
independent_component_analysis_(ica)	independent_component_analysis
orthogonal_frequency-division_multiplexing_(ofdm)	orthogonal_frequency-division_multiplexing
radial_basis_function_(rbf)_network	radial_basis_function
spatial_data_mining_(sdm)	spatial_data_mining
power_transmission_(mechanical)	power_transmission
nonnegative_matrix_factorization_(nmf)	nonnegative_matrix_factorization
discrete_wavelet_transform_(dwt)	discrete_wavelet_transform
fuzzy_c-means_(fcm)	fuzzy_c-means
data_warehouse_(dw)	data_warehouse
multi-input_multi-output_(mimo)	multi-input_multi-output
approximate_dynamic_programming_(adp)	approximate_dynamic_programming
hidden_markov_models_(hmms)	hidden_markov_models
dissolved_gas_analysis_(dga)	dissolved_gas_analysis
gene_ontology_(go)	gene_ontology
touch_(physiological)	touch
theory_of_computation_(general)	theory_of_computation
graphic_processing_units_(gpus)	graphic_processing_units
orientation_distribution_function_(odf)	orientation_distribution_function
ai_(artificial_intelligence)	ai
relevance_feedback_(rf)	relevance_feedback
face_recognition_(fr)	face_recognition
variable_carrying_numbers_(vcn)	variable_carrying_numbers
machine_learning_(ml)	machine_learning
technology_computer-aided_design_(tcad)	technology_computer-aided_design
dynamic_voltage_scaling_(dvs)	dynamic_voltage_scaling
trajectory_optimisation_(aerospace)	trajectory_optimisation
thermal_management_(packaging)	thermal_management
intelligent_transportation_systems_(its)	intelligent_transportation_systems
markov_chain_monte_carlo_(mcmc)	markov_chain_monte_carlo
fixed_carrying_numbers_(fcn)	fixed_carrying_numbers
least_squares_support_vector_machine_(ls-svm)	least_squares_support_vector_machine
recurrent_neural_networks_(rnns)	recurrent_neural_networks
partial_transmit_sequence_(pts)	partial_transmit_sequence
impact_(mechanical)	impact
ultra-wideband_(uwb)	ultra-wideband
screens_(display)	screens
house_of_quality_(hoq)	house_of_quality
partial_transmit_sequences_(pts)	partial_transmit_sequences
duality_(mathematics)	duality
electromyography_(emg)	electromyography
recurrent_neural_network_(rnn)	recurrent_neural_network
hardware_in_the_loop_(hil)	hardware_in_the_loop
multitask_learning_(mtl)	multitask_learning
generalized_gaussian_density_(ggd)_model	generalized_gaussian_density
time_division_multiple_access_(tdma)	time_division_multiple_access
self-organizing_maps_(soms)	self-organizing_maps
blind_source_separation_(bss)	blind_source_separation
anechoic_chambers_(electromagnetic)	anechoic_chambers
discrete_cosine_transform_(dct)	discrete_cosine_transform
rare_earth_(re)_compound	rare_earth
arabic_sign_language_(arsl)	arabic_sign_language
depth_image-based_rendering_(dibr)	depth_image-based_rendering
space_vector_modulation_(svm)	space_vector_modulation
cements_(building_materials)	cements
high_performance_liquid_chromatography_(hplc)	high_performance_liquid_chromatography
multiple-instance_learning_(mil)	multiple-instance_learning
online_analytical_processing_(olap)	online_analytical_processing
application_specific_integrated_circuit_(asic)	application_specific_integrated_circuit
motion_estimation_(me)	motion_estimation
graphics_processing_units_(gpu)	graphics_processing_units
environmental_monitoring_(geophysics)	environmental_monitoring
arcs_(electric)	arcs
intake_systems_(machines)	intake_systems
routing_and_wavelength_assignment_(rwa)	routing_and_wavelength_assignment
remote_sensing_(rs)	remote_sensing
radial_basis_function_network_(rbfn)	radial_basis_function_network
optical_character_recognition_(ocr)	optical_character_recognition
wireless_mesh_network_(wmn)	wireless_mesh_network
on-line_analytical_mining_(olam)	on-line_analytical_mining
resource_description_framework_(rdf)	resource_description_framework
adaptive_neuro-fuzzy_inference_system_(anfis)	adaptive_neuro-fuzzy_inference_system
direct_numerical_simulation_(dns)	direct_numerical_simulation
time-of-flight_(tof)	time-of-flight
non-homogeneous_poisson_process_(nhpp)	non-homogeneous_poisson_process
intrusion_detection_system_(ids)	intrusion_detection_system
global_positioning_system_(gps)	global_positioning_system
cells_(electric)	cells
extended_kalman_filter_(ekf)	extended_kalman_filter
mobile_cloud_computing_(mcc)	mobile_cloud_computing
local_binary_pattern_(lbp)	local_binary_pattern
self-organizing_maps_(som)	self-organizing_maps
orthogonal_frequency-division_multiple_access_(ofdma)	orthogonal_frequency-division_multiple_access
qr_decomposition_(qrd)	qr_decomposition
vehicle_routing_problem_(vrp)	vehicle_routing_problem
computer-aided_diagnosis_(cad)	computer-aided_diagnosis
intercarrier_interference_(ici)	intercarrier_interference
amplify-and-forward_(af)	amplify-and-forward
fisher_discriminant_analysis_(fda)	fisher_discriminant_analysis
gaussian_mixture_model_(gmm)	gaussian_mixture_model
software_quality_assurance_(sqa)	software_quality_assurance
high_range_resolution_profile_(hrrp)	high_range_resolution_profile
generalized_eigenvalue_problem_(gevp)	generalized_eigenvalue_problem
cerebellar_model_articulation_controller_(cmac)	cerebellar_model_articulation_controller
software_process_improvement_(spi)	software_process_improvement
personal_software_process_(psp)	personal_software_process
functional_programming	functional_programming_languages
debug	program_debugging
neural_net	neural_networks
artificial_neural_network	neural_networks
database_management_systems	database
very_large_databases	large_database
performance	performance_evaluation
high_performance	high_performance_computing
parallel_processing	parallel_computation
high-performance_computing	high_performance_computing
machine_vision	robot_vision
face_detection	face_recognition
object_detection	object_recognition
language_processing	natural_language_processing
kernel_function	kernel_method